1 2 7 7 7 7 7 7 7 7 7 2 7 7 7 7 7 7 7 7 7 2 2 1 1 1 4 1 1 1 1 1 1 1 1 1 1 1 1 1 1 1 1 1 9 1 1 1 8 1 1 1 1 1 1 1 1 1 1 1 1 1 1 1 1 1 1 1 1 1 1 1 1 1 1 1 1 1 1 1
1 9 3 3 3 3 3 3 3 3 3 4 3 3 3 3 3 3 3 3 3 8 9 0 0 0 2 7 7 7 7 7 7 7 7 7 7 7 7 7 7 7 7 7 2 0 0 0 8 1 1 1 1 1 1 1 1 1 1 1 1 1 1 1 1 1 1 1 1 1 1 1 1 1 1 1 1 1 1 1
1 9 0 0 0 0 0 0 0 0 0 4 0 0 0 0 0 0 0 0 0 8 9 0 0 0 3 3 3 3 3 3 3 3 3 3 3 3 3 3 3 3 3 3 3 0 0 0 8 1 1 1 1 1 1 1 1 1 1 1 1 1 1 1 1 1 1 1 1 1 1 1 1 1 1 1 1 1 1 1
1 9 0 0 0 0 0 0 0 0 0 4 0 0 0 0 0 0 0 0 0 8 9 0 0 0 0 0 0 0 0 0 0 0 0 0 0 0 0 0 0 0 0 0 0 0 0 0 8 1 1 1 1 1 1 1 1 1 1 1 1 1 1 1 1 1 1 1 2 7 7 7 7 7 7 7 7 7 7 2
1 9 0 0 0 0 0 0 0 0 0 4 0 0 0 0 0 0 0 0 0 8 9 0 0 0 0 0 0 0 0 0 0 0 0 0 0 0 0 0 0 0 0 0 0 0 0 0 8 1 1 1 1 1 1 1 1 1 1 1 1 1 1 1 1 1 1 1 9 3 3 3 3 3 3 3 3 3 3 8
1 9 0 0 0 0 0 0 0 0 0 4 0 0 0 0 0 0 0 0 0 8 9 0 0 0 2 5 5 5 5 5 5 5 5 5 5 5 5 5 5 5 5 5 2 0 0 0 2 7 7 7 7 7 7 7 7 7 7 7 7 7 7 7 7 7 7 7 2 0 0 0 0 0 0 0 0 0 0 8
1 9 0 0 0 0 0 0 0 0 0 4 0 0 0 0 0 0 0 0 0 8 9 0 0 0 4 3 3 3 3 3 3 3 3 3 3 3 3 3 3 3 3 3 4 0 0 0 3 3 3 3 3 3 3 3 3 3 3 3 3 3 3 3 3 3 3 3 4 0 0 0 0 0 0 0 0 0 0 8
1 9 0 0 0 0 0 0 0 0 0 4 0 0 0 0 0 0 0 0 0 8 9 0 0 0 4 0 0 0 0 0 0 0 1 0 1 0 1 0 1 0 1 0 4 0 0 0 0 0 0 0 0 0 0 0 0 0 0 0 0 0 0 0 0 0 0 0 2 0 0 0 0 0 0 0 0 0 0 8
1 9 0 0 0 0 0 0 0 0 0 4 0 0 0 0 0 0 0 0 0 8 9 0 0 0 4 0 0 0 0 0 0 0 1 0 1 0 1 0 1 0 1 0 2 0 0 0 0 0 0 0 0 0 0 0 0 0 0 0 0 0 0 0 0 0 0 0 3 0 0 0 0 0 0 0 0 0 0 8
1 9 0 0 0 0 0 0 0 0 0 4 0 0 0 0 0 0 0 0 0 8 9 0 0 0 4 0 0 0 0 0 0 0 0 0 0 0 0 0 0 0 0 0 3 0 0 0 2 6 6 6 6 6 6 6 6 6 6 6 6 6 6 6 2 0 0 0 0 0 0 0 0 0 0 0 0 0 0 8
1 2 5 5 5 5 5 2 0 0 2 2 2 0 0 2 5 5 5 5 5 2 2 0 0 0 4 0 0 0 0 0 0 0 0 0 0 0 0 0 0 0 0 0 0 0 0 0 8 1 1 1 1 1 1 1 1 1 1 1 1 1 1 1 9 0 0 0 2 0 0 0 0 0 0 0 0 0 0 8
1 3 3 3 3 3 3 3 0 0 3 3 3 0 0 3 3 3 3 3 3 3 3 0 0 0 4 0 0 0 0 0 0 0 1 0 1 0 1 0 1 0 1 0 2 0 0 0 8 1 1 1 1 1 1 1 1 1 1 1 1 1 1 1 9 0 0 0 2 5 5 5 5 5 5 5 5 5 5 2
1 0 0 0 0 0 0 0 0 0 0 0 0 0 0 0 0 0 0 0 0 0 0 0 0 0 4 0 0 0 0 0 0 0 1 0 1 0 1 0 1 0 1 0 4 0 0 0 8 1 1 1 1 1 1 1 1 1 1 1 1 1 1 1 9 0 0 0 2 3 3 3 3 3 3 3 3 3 3 2
1 0 0 0 0 0 0 0 0 0 0 0 0 0 0 0 0 0 0 0 0 0 0 0 0 0 4 0 0 0 0 0 0 0 1 0 1 0 1 0 1 0 1 0 4 0 0 0 8 1 1 1 1 1 1 1 1 1 1 1 1 1 1 1 9 0 0 0 3 0 0 0 0 0 0 0 0 0 0 8
1 2 5 5 5 2 5 5 5 5 5 5 2 0 0 2 0 0 2 5 5 2 2 0 0 0 4 0 0 0 0 0 0 0 1 0 1 0 1 0 1 0 1 0 4 0 0 0 2 7 7 7 7 7 7 7 7 7 7 7 7 7 7 7 2 0 0 0 0 0 0 0 0 0 0 0 0 0 0 8
1 9 3 3 3 4 3 3 3 3 3 3 3 0 0 3 0 0 3 3 3 8 9 0 0 0 4 0 0 0 0 0 0 0 1 0 1 0 1 0 1 0 1 0 4 0 0 0 3 3 3 3 3 3 3 3 3 3 3 3 3 3 3 3 3 0 0 0 2 0 0 0 0 0 0 0 0 0 0 8
1 9 0 0 0 4 0 1 0 0 0 0 0 0 0 0 0 0 0 0 0 8 9 0 0 0 4 0 0 0 0 0 0 0 1 0 1 0 1 0 1 0 1 0 4 0 0 0 0 0 0 0 0 0 0 0 0 0 0 0 0 0 0 0 0 0 0 0 4 0 0 0 0 0 0 0 0 0 0 8
1 9 0 0 0 4 0 1 0 0 0 0 0 0 0 0 0 0 0 0 0 8 9 0 0 0 4 0 0 0 0 0 0 0 1 0 1 0 1 0 1 0 1 0 4 0 0 0 0 0 0 0 0 0 0 0 0 0 0 0 0 0 0 0 0 0 0 0 4 0 0 0 0 0 0 0 0 0 0 8
1 9 0 0 0 4 0 1 0 0 0 0 0 0 0 0 0 0 0 0 0 8 9 0 0 0 4 0 0 0 0 0 0 0 1 0 1 0 1 0 1 0 1 0 2 0 0 0 2 6 6 6 6 6 6 6 6 6 6 6 6 6 6 6 6 6 6 6 2 0 0 0 0 0 0 0 0 0 0 8
1 9 0 0 0 4 0 1 0 0 0 0 0 0 0 0 0 0 0 0 0 8 9 0 0 0 4 0 0 0 0 0 0 0 0 0 0 0 0 0 0 0 0 0 3 0 0 0 8 1 1 1 1 1 1 1 1 1 1 1 1 1 1 1 1 1 1 1 2 6 6 6 6 6 6 6 6 6 6 2
1 9 0 0 0 2 0 1 0 0 0 0 0 0 0 0 0 0 0 0 0 8 9 0 0 0 4 0 0 0 0 0 0 0 0 0 0 0 0 0 0 0 0 0 0 0 0 0 8 1 1 1 1 1 1 1 1 1 1 1 1 1 1 1 1 1 1 1 1 1 1 1 1 1 1 1 1 1 1 1
1 9 0 0 0 3 0 1 0 0 0 0 0 0 0 0 0 0 0 0 0 8 9 0 0 0 4 0 0 0 0 0 0 0 1 0 1 0 1 0 1 0 1 0 2 6 6 6 2 1 1 1 1 1 1 1 1 1 1 1 1 1 1 1 1 1 1 1 1 1 1 1 1 1 1 1 1 1 1 1
1 9 0 0 0 0 0 0 0 0 0 0 0 0 0 0 0 0 0 0 0 8 9 0 0 0 4 0 0 0 0 0 0 0 1 0 1 0 1 0 1 0 1 0 8 1 1 1 1 1 1 1 1 1 1 1 1 1 1 1 1 1 1 1 1 1 1 1 1 1 1 1 1 1 1 1 1 1 1 1
1 9 0 0 0 2 0 0 0 0 0 0 0 0 0 0 0 0 0 0 0 8 9 0 0 0 4 0 0 0 0 0 0 0 1 0 1 0 1 0 1 0 1 0 8 1 1 1 1 1 1 1 1 1 1 1 1 1 1 1 1 1 1 1 1 1 1 1 1 1 1 1 1 1 1 1 1 1 1 1
6 2 6 6 6 2 6 6 6 6 6 6 6 6 6 6 6 6 6 6 6 2 9 0 0 0 2 6 6 6 6 6 6 6 6 6 6 6 6 6 6 6 6 6 2 1 1 1 1 1 1 1 1 1 1 1 1 1 1 1 1 1 1 1 1 1 1 1 1 1 1 1 1 1 1 1 1 1 1 1
